keybindings|keybindings|around
SIGALRM|SIGALRM|around
handler|handler|around
gamemoderun|gamemoderun|around
paccache|paccache|languageserver.bash
NvimTreeT|NvimTreeToggle|around
Nvim|NvimTree_|around
nvim|nvim_tree_highlight|around
endfunction|endfunction|around
spaces|spaces|around
StripTra|StripTrailingWhitespace|around
Str|StripTrailingWhitespace|around
StripTrailing|StripTrailingWhitespace|around
S|Select|around
rsv|rsv|around
lxappea|lxappearance|around
pavucontrol|pavucontrol|languageserver.bash
services|services|around
wif|wifi|around
connmanctl|connmanctl|around
mnt|mnt|file
pacman.conf|pacman.conf|file
su|situation|around
ISO|ISO|around
Brian|Brian|around
my_|my_custom_script|around
my|my_custom_script|around
hello|hello|around
QAp|QApplication|around
QWidget|QtWidgets|around
window|window|around
gcolor|gcolor3|around
conf|conf|around
lias|liasSh|around
nord|nord_sand.png|file
screen|screen|around
G|GradientGlowPenguin.jpg|file
Pictu|Pictures|file
keyboard|keyboard|around
then|then|languageserver.bash
txt|txt|around
File|File|around
ghostscript|ghostscript|around
2|2048|around
hexa|hexadecimal|around
repre|representation|around
omdb|omdbapi_key|around
Mail|Mail|file
|session|file
tmux|tmux|around
tab|tab|around
remember|remember_window_size|around
yarr|yArr|tsserver-javascript
see|serve|buffer
the|them|around